12  18  18  18  18  18  18  18  18  18  18  18  18  18  18  18  18  18  18  18  15
12  0   0   0   0   0   0   0   0   0   0   0   0   0   0   0   0   0   0   0   15
12  0   0   0   0   0   0   0   0   0   0   0   0   0   0   0   0   0   0   0   15
12  0   0   0   0   0   0   0   0   0   0   0   0   0   0   0   0   0   0   0   15
12  0   0   0   0   0   0   0   0   0   0   0   0   0   0   0   0   0   0   0   15
12  0   0   0   0   0   0   0   0   0   0   0   0   0   0   0   0   0   0   0   15
12  0   0   0   0   0   0   0   0   0   0   0   0   0   0   0   0   0   0   0   15
12  0   0   0   0   0   0   0   0   0   0   0   0   0   0   0   0   0   0   0   15
12  0   0   0   0   0   0   0   0   0   0   0   0   0   0   0   0   0   0   0   15
12  0   0   0   0   0   0   0   0   0   0   0   0   0   0   0   0   0   0   0   15
12  0   0   0   0   0   0   0   0   0   0   0   0   0   0   0   0   0   0   0   15
12  0   0   0   0   0   0   0   0   0   0   0   0   0   0   0   0   0   0   0   15
12  0   0   0   0   0   0   0   0   0   0   0   0   0   0   0   0   0   0   0   15
12  0   0   0   0   0   0   0   0   0   0   0   0   0   0   0   0   0   0   0   15
14  10  10  10  10  10  10  10  10  10  10  10  10  10  10  10  10  10  10  10  17